aba-aba: arahan, instruksi, isyarat, kode, komando, perintah, petunjuk, suruhan, tanda,
pengawalan:
isyarat: aba-aba, duaja, gestur, kode, sandi, semboyan, sinyal, tanda, gejala, gelagat, indikasi, pelebaya, petunjuk, sasmita, semboyan, tengara,
pelebaya: gejala, gelagat, indikasi, isyarat, pertanda, sinyal,
bahan:
panduan: arahan, bimbingan, pedoman, tip, petunjuk, manual,
semboyan: sandi, isyarat, sinyal, tanda,
sabda: arahan, firman, titah,
bisikan: ilham,
titah: amanat, firman, perintah, sabda,
sandi: isyarat, kode, semboyan,
sasmita: isyarat,
wangsit: ilham, petunjuk, wahyu,
fatwa: ajaran, masukan, nasihat, pengarahan, petuah, petunjuk,
amanat: arahan, instruksi, mandat, nasihat, perintah, permintaan, pesan, suruhan, titah, ajaran, keterangan, nasihat, petuah,
pendidikan: bimbingan,
pesan: suruhan, amanat, nasihat, petuah,
suruhan: aba-aba, amanat, komando, perintah, pesan, tugas,
alamat:
informasi: data, fakta, keterangan,
komando: aba-aba, instruksi, perintah, suruhan,
mandat: amanat, arahan, perintah,
ajakan: anjuran, lambaian, nasihat, panggilan, permintaan, seruan, undangan,
hukum: kaidah, norma, patokan,
atribut: ciri, petunjuk, tanda, tanda,
tanda: atribut, ciri, markah, semboyan, semboyan, indikasi, isyarat, petunjuk, sinyal, tengara, aba-aba, kode, bukti, keterangan,
gelagat: bakat, gejala, indikasi, isyarat, pelebaya, petunjuk, sinyal, tengara,
ketentuan:
masukan: bukti, data, fakta, fatwa, pengarahan, petuah, petunjuk,
tip: manual, panduan, pedoman, petunjuk,
pesuruh:
anjuran: ajakan, panggilan, permintaan, seruan, undangan, nasihat,
firman: sabda, titah,
pengarahan: bimbingan, fatwa, masukan, nasihat, petuah, petunjuk,
gestur: isyarat,
ajaran: amanat, fatwa, ilham, petuah, petunjuk, wahyu, kaidah,
rodi:
keterangan: amanat, bukti, data, fakta, informasi, petunjuk, tanda,
gejala: fakta, gelagat, indikasi, isyarat, pelebaya, petunjuk, sinyal,
ciri: atribut, bukti, petunjuk, tanda,
aturan: kaidah, norma, preskripsi,
kompas: arah, pedoman, petunjuk,
petunjuk: bakat, gejala, gelagat, indikasi, isyarat, sinyal, atribut, markah, tanda, aba-aba, bukti, ciri, data, fakta, keterangan, masukan, kaidah, patokan, preskripsi, kompas, manual, panduan, pedoman, tip, ajaran, bimbingan, fatwa, nasihat, pengarahan, petuah, ilham, wahyu, wangsit,
laung: seruan,
patokan: hukum, kaidah, norma, pedoman, peraturan, petunjuk,
preskripsi: aturan, petunjuk,
lambaian: ajakan, panggilan, seruan, undangan,
norma: aturan, hukum, kaidah, patokan, pedoman,
pertanda: pelebaya,
tengara: gelagat, indikasi, isyarat, tanda,
instruksi: aba-aba, amanat, komando, nasihat, perintah, tugas,
indikasi: bakat, gejala, gelagat, isyarat, pelebaya, petunjuk, sinyal, tanda, tengara,
tuntunan: arahan, bimbingan,
seruan: laung, ajakan, anjuran, lambaian, panggilan, permintaan, undangan,
markah: petunjuk, tanda,
duaja: isyarat, kode,
petuah: ajaran, amanat, fatwa, masukan, nasihat, pengarahan, pesan, petunjuk,
ilham: ajaran, petunjuk, wahyu, wangsit, bisikan,
wahyu: ajaran, ilham, petunjuk, wangsit,
data: bukti, fakta, informasi, keterangan, masukan, petunjuk,
pimpinan: arahan, bimbingan,
bakat: gelagat, indikasi, petunjuk, sinyal,
rambu-rambu:
fakta: bukti, data, gejala, informasi, keterangan, masukan, petunjuk,
peraturan: kaidah, patokan,
resep:
pedoman: kompas, arahan, manual, panduan, petunjuk, tip, kaidah, norma, patokan,
bimbingan: panduan, pengarahan, petunjuk, pimpinan, tuntunan, pendidikan, tuntunan,
nasihat: ajakan, anjuran, fatwa, instruksi, pengarahan, petuah, petunjuk, amanat, pesan,
bukti: ciri, data, fakta, keterangan, masukan, petunjuk, tanda,
kode: aba-aba, duaja, isyarat, sandi, tanda, kaidah,
manual: petunjuk, panduan, pedoman, tip,
sinyal: tanda, bakat, gejala, gelagat, indikasi, pelebaya, petunjuk, semboyan, isyarat,
undangan: ajakan, anjuran, lambaian, panggilan, permintaan, seruan,
order: perintah,
perintah: aba-aba, amanat, arahan, instruksi, komando, mandat, order, suruhan, titah, tugas,
pelatihan:
asas:
permintaan: ajakan, amanat, anjuran, panggilan, seruan, undangan,
tugas: instruksi, perintah, suruhan,
kaidah: ajaran, hukum, kode, norma, patokan, pedoman, peraturan, petunjuk, aturan,
panggilan: ajakan, anjuran, lambaian, permintaan, seruan, undangan,
arahan: panduan, pedoman, perintah, pimpinan, sabda, tuntunan, aba-aba, amanat, mandat,
arah: kompas,
